00000000001111111111
11111111101111111111
11111111101111111111
11111111101111111111
11111111101111111111
11111111101111111111
00000000001111111111
01111111111111111111
01111111111000000000
01111111111011111110
01111111111011111110
00000000000011111110
11111111111111111110